111111111111111111111111111111111
1001000C0000111111111111111111111
10E000111100011111111111111111111
1P0011E00000011111111111111111111
111111111111111111111111111111111
111111111111111111111111111111111
111111111111111111111111111111111
111111111111111111111111111111111
