11111111111111
1E0000000110C1
1100001P000011
11111111111111
