11111111111111
1001000C000011
10E00011110001
1P0011E0000001
11111111111111
