111111111111111
10CC00C000P0E11
10E0C0111100E11
111111111111111
